###                 #########
#   ###################   # #
# ####                  # # #
# ################### # # # #
#                     # # # #
##################### # # # #
#   ##                # # # #
# # ## ### ## ######### # # #
# #    #   ## #         # # #
# # ## ################ # # #
### ##             #### # # #
### #################B# # # #
###       #     ##      # # #
###### ######## ####### # # #
###### ####             #   #
A      ######################
